5
9,9,9,9,9,9,9,9,9,9,
9,0,0,0,0,0,0,0,6,9,
9,0,0,0,0,0,0,0,6,9,
9,0,0,0,0,0,0,0,0,9,
9,0,0,9,0,4,0,0,0,9,
7,0,0,9,0,0,8,0,0,9,
9,5,0,9,0,0,0,0,0,9,
9,0,0,0,0,0,0,0,6,9,
9,0,0,0,0,0,0,0,0,9,
9,9,9,9,9,9,9,9,9,9,