5
9,9,9,9,9,9,9,9,9,9,
9,0,0,0,0,0,0,0,0,9,
9,0,9,9,9,9,9,9,0,9,
9,0,0,0,0,0,0,9,0,9,
9,0,0,0,0,0,0,9,0,9,
9,0,8,0,5,0,0,9,0,7,
9,0,0,0,0,0,0,9,0,9,
9,0,9,9,9,9,9,9,0,9,
9,0,0,0,0,0,0,0,0,9,
9,9,9,9,9,9,9,9,9,9,