8
9,9,9,9,9,9,9,9,9,9,
9,8,0,0,0,1,0,0,0,9,
9,0,0,0,0,0,0,0,0,9,
9,0,0,9,0,9,9,0,0,9,
9,0,0,9,0,0,9,0,0,9,
9,6,0,9,0,0,9,0,0,9,
9,9,9,9,0,0,9,0,0,9,
9,0,0,5,0,0,9,0,0,9,
9,0,0,0,0,0,9,0,9,9,
9,9,9,9,9,9,9,9,9,7