1
9,9,9,9,9,9,9,9,9,9,
7,0,0,0,0,0,0,0,0,9,
9,1,0,0,0,0,0,0,0,9,
9,0,0,0,0,0,0,0,0,9,
9,0,0,0,8,6,0,0,0,9,
9,0,0,0,6,6,0,0,0,9,
9,0,0,0,0,0,0,0,0,9,
9,0,0,0,0,0,0,0,0,9,
9,0,0,0,0,0,0,0,0,9,
9,9,9,9,9,9,9,9,9,9,