10
9,9,9,9,7,9,9,9,9,9,
9,0,6,0,0,0,9,6,0,9,
9,0,0,0,0,0,9,9,0,9,
9,9,9,9,8,0,9,0,9,9,
9,0,4,9,0,9,9,0,0,9,
9,0,9,9,0,9,0,9,0,9,
9,0,0,9,0,9,0,9,0,9,
9,0,0,9,0,9,0,9,0,9,
9,0,0,0,0,0,0,0,0,9,
9,9,9,9,9,9,9,9,9,9,